20 20 9 10 3 3 16 16 3 18
####################
#         #        #
# #### #### #### # #
# #  # #         # #
# ## # ####  #######
# #      ##      # #
# ####   --    # # #
#  # # ##### ###   #
# ## #         ### #
#    # ## ####   # #
###     # #     ##-#
# #########-#####--#
#      #H---#    --#
# #### #-#########-#
# #    #-#       --#
# ######-# ##### # #
# ---      #   # # #
# ######## #-#-### #
# #          #     #
####################